0 18 0 0 0 255 255 255 255 0 14 14
0 17 0 0 0 255 255 255 255 0 14 14
0 16 0 0 0 255 255 255 255 0 14 14
0 15 0 0 0 255 255 255 255 0 14 14
0 14 0 0 0 255 255 255 255 0 14 14
0 13 0 0 0 255 255 255 255 0 14 14
0 12 0 0 0 255 255 255 255 0 14 14
0 11 0 0 0 255 255 255 255 0 14 14
0 10 0 0 0 255 255 255 255 0 14 14
0 9 0 0 0 255 255 255 255 0 14 14
0 8 0 0 0 255 255 255 255 0 14 14
0 7 0 0 0 255 255 255 255 0 14 14
0 6 0 0 0 255 255 255 255 0 14 14
0 5 0 0 0 255 255 255 255 0 14 14
0 4 0 0 0 255 255 255 255 0 14 14
0 3 0 0 0 255 255 255 255 0 14 14
0 2 0 0 0 255 255 255 255 0 14 14
0 1 0 0 0 255 255 255 255 0 14 14
0 0 0 0 0 255 255 255 255 0 14 14
1 0 0 0 0 255 255 255 255 0 14 14
2 0 0 0 0 255 255 255 255 0 14 14
3 0 0 0 0 255 255 255 255 0 14 14
4 0 0 0 0 255 255 255 255 0 14 14
5 0 0 0 0 255 255 255 255 0 14 14
6 0 0 0 0 255 255 255 255 0 14 14
7 0 0 0 0 255 255 255 255 0 14 14
8 0 0 0 0 255 255 255 255 0 14 14
9 0 0 0 0 255 255 255 255 0 14 14
10 0 0 0 0 255 255 255 255 0 14 14
11 0 0 0 0 255 255 255 255 0 14 14
12 0 0 0 0 255 255 255 255 0 14 14
13 0 0 0 0 255 255 255 255 0 14 14
14 0 0 0 0 255 255 255 255 0 14 14
15 0 0 0 0 255 255 255 255 0 14 14
16 0 0 0 0 255 255 255 255 0 14 14
17 0 0 0 0 255 255 255 255 0 14 14
18 0 0 0 0 255 255 255 255 0 14 14
19 18 0 0 0 255 255 255 255 0 14 14
19 16 0 0 0 255 255 255 255 0 14 14
19 15 0 0 0 255 255 255 255 0 14 14
19 14 0 0 0 255 255 255 255 0 14 14
19 13 0 0 0 255 255 255 255 0 14 14
19 12 0 0 0 255 255 255 255 0 14 14
19 10 0 0 0 255 255 255 255 0 14 14
19 9 0 0 0 255 255 255 255 0 14 14
19 8 0 0 0 255 255 255 255 0 14 14
19 7 0 0 0 255 255 255 255 0 14 14
19 6 0 0 0 255 255 255 255 0 14 14
19 5 0 0 0 255 255 255 255 0 14 14
19 4 0 0 0 255 255 255 255 0 14 14
19 3 0 0 0 255 255 255 255 0 14 14
19 2 0 0 0 255 255 255 255 0 14 14
19 1 0 0 0 255 255 255 255 0 14 14
19 0 0 0 0 255 255 255 255 0 14 14
19 11 0 0 0 255 255 255 255 0 14 14
19 17 0 0 0 255 255 255 255 0 14 14
0 19 0 0 0 255 255 255 255 0 14 14
1 19 0 0 0 255 255 255 255 0 14 14
2 19 0 0 0 255 255 255 255 0 14 14
3 19 0 0 0 255 255 255 255 0 14 14
4 19 0 0 0 255 255 255 255 0 14 14
5 19 0 0 0 255 255 255 255 0 14 14
6 19 0 0 0 255 255 255 255 0 14 14
7 19 0 0 0 255 255 255 255 0 14 14
8 19 0 0 0 255 255 255 255 0 14 14
9 19 0 0 0 255 255 255 255 0 14 14
10 19 0 0 0 255 255 255 255 0 14 14
11 19 0 0 0 255 255 255 255 0 14 14
12 19 0 0 0 255 255 255 255 0 14 14
13 19 0 0 0 255 255 255 255 0 14 14
14 19 0 0 0 255 255 255 255 0 14 14
15 19 0 0 0 255 255 255 255 0 14 14
16 19 0 0 0 255 255 255 255 0 14 14
17 19 0 0 0 255 255 255 255 0 14 14
18 19 0 0 0 255 255 255 255 0 14 14
19 19 0 0 0 255 255 255 255 0 14 14
3 17 0 0 0 255 255 255 255 0 14 14
5 16 0 0 0 255 255 255 255 0 14 14
7 15 0 0 0 255 255 255 255 0 14 14
9 13 0 0 0 255 255 255 255 0 14 14
10 12 0 0 0 255 255 255 255 0 14 14
11 12 0 0 0 255 255 255 255 0 14 14
12 12 0 0 0 255 255 255 255 0 14 14
13 12 0 0 0 255 255 255 255 0 14 14
14 12 0 0 0 255 255 255 255 0 14 14
15 12 0 0 0 255 255 255 255 0 14 14
16 12 0 0 0 255 255 255 255 0 14 14
17 12 0 0 0 255 255 255 255 0 14 14
18 12 0 0 0 255 255 255 255 0 14 14
8 15 0 0 0 255 255 255 255 0 14 14
9 15 0 0 0 255 255 255 255 0 14 14
10 15 0 0 0 255 255 255 255 0 14 14
11 15 0 0 0 255 255 255 255 0 14 14
12 15 0 0 0 255 255 255 255 0 14 14
13 15 0 0 0 255 255 255 255 0 14 14
14 15 0 0 0 255 255 255 255 0 14 14
15 15 0 0 0 255 255 255 255 0 14 14
16 15 0 0 0 255 255 255 255 0 14 14
17 15 0 0 0 255 255 255 255 0 14 14
18 15 0 0 0 255 255 255 255 0 14 14
6 12 0 0 0 255 255 255 255 0 14 14
5 12 0 0 0 255 255 255 255 0 14 14
4 12 0 0 0 255 255 255 255 0 14 14
3 12 0 0 0 255 255 255 255 0 14 14
2 12 0 0 0 255 255 255 255 0 14 14
1 12 0 0 0 255 255 255 255 0 14 14
2 10 0 0 0 255 255 255 255 0 14 14
3 9 0 0 0 255 255 255 255 0 14 14
1 8 0 0 0 255 255 255 255 0 14 14
3 7 0 0 0 255 255 255 255 0 14 14
1 6 0 0 0 255 255 255 255 0 14 14
3 5 0 0 0 255 255 255 255 0 14 14
5 5 0 0 0 255 255 255 255 0 14 14
4 5 0 0 0 255 255 255 255 0 14 14
6 5 0 0 0 255 255 255 255 0 14 14
7 5 0 0 0 255 255 255 255 0 14 14
8 5 0 0 0 255 255 255 255 0 14 14
9 5 0 0 0 255 255 255 255 0 14 14
10 5 0 0 0 255 255 255 255 0 14 14
11 5 0 0 0 255 255 255 255 0 14 14
12 5 0 0 0 255 255 255 255 0 14 14
13 5 0 0 0 255 255 255 255 0 14 14
14 5 0 0 0 255 255 255 255 0 14 14
15 5 0 0 0 255 255 255 255 0 14 14
16 5 0 0 0 255 255 255 255 0 14 14
17 5 0 0 0 255 255 255 255 0 14 14
18 5 0 0 0 255 255 255 255 0 14 14
12 9 0 0 0 255 255 255 255 0 14 14
12 8 0 0 0 255 255 255 255 0 14 14
12 7 0 0 0 255 255 255 255 0 14 14
12 6 0 0 0 255 255 255 255 0 14 14
16 9 0 0 0 255 255 255 255 0 14 14
17 9 0 0 0 255 255 255 255 0 14 14
18 9 0 0 0 255 255 255 255 0 14 14
14 10 0 0 0 255 255 255 255 0 14 14
8 11 0 0 0 255 255 255 255 0 14 14
10 9 0 0 0 255 255 255 255 0 14 14
11 9 0 0 0 255 255 255 255 0 14 14
8 8 0 0 0 255 255 255 255 0 14 14
6 8 0 0 0 255 255 255 255 0 14 14
5 8 0 0 0 255 255 255 255 0 14 14
5 7 0 0 0 255 255 255 255 0 14 14
5 6 0 0 0 255 255 255 255 0 14 14
4 1 0 0 0 255 255 255 255 0 14 14
4 2 0 0 0 255 255 255 255 0 14 14
9 4 0 0 0 255 255 255 255 0 14 14
10 4 0 0 0 255 255 255 255 0 14 14
11 4 0 0 0 255 255 255 255 0 14 14
12 4 0 0 0 255 255 255 255 0 14 14
13 4 0 0 0 255 255 255 255 0 14 14
14 4 0 0 0 255 255 255 255 0 14 14
15 4 0 0 0 255 255 255 255 0 14 14
16 4 0 0 0 255 255 255 255 0 14 14
17 4 0 0 0 255 255 255 255 0 14 14
18 4 0 0 0 255 255 255 255 0 14 14
10 18 0 0 1 255 255 255 255 0 14 14
15 18 0 0 1 255 255 255 255 0 14 14
15 17 0 0 1 255 255 255 255 0 14 14
16 18 0 0 1 255 255 255 255 0 14 14
13 14 0 0 1 255 255 255 255 0 14 14
16 14 0 0 1 255 255 255 255 0 14 14
18 8 0 0 1 255 255 255 255 0 14 14
17 8 0 0 1 255 255 255 255 0 14 14
17 7 0 0 1 255 255 255 255 0 14 14
17 11 0 0 1 255 255 255 255 0 14 14
4 11 0 0 1 255 255 255 255 0 14 14
3 8 0 0 1 255 255 255 255 0 14 14
12 3 0 0 1 255 255 255 255 0 14 14
16 3 0 0 1 255 255 255 255 0 14 14
18 3 0 0 1 255 255 255 255 0 14 14
6 4 0 0 1 255 255 255 255 0 14 14
3 4 0 0 1 255 255 255 255 0 14 14
